###################
#        #        #        
# ## ### # ### ## #
#                 #
# ## # ##### # ## #
#    #   #   #    #
# ## ### # ### ## #
# ## #       # ## #
# ## # #BS## # ## #
#      #JPM#      #
# ## # ##### # ## #
#    #       #    #
# ## # ##### # ## #
#        #        #
# ## ### # ### ## #
#  #     I     #  #
## # # ##### # # ##
#    #   #   #    #
# ###### # ###### #
#                 #
###################
